1111111111111
1001000000001
1000011111CC1
1P0011EEEEEE1
1111111111111